  _____       _       _                   _                     _
 |  __ \     (_)     | |                 | |                   | |
 | |__) |__ _ _ _ __ | |__   _____      _| |     __ _ _ __   __| |
 |  _  // _` | | '_ \| '_ \ / _ \ \ /\ / / |    / _` | '_ \ / _` |
 | | \ \ (_| | | | | | |_) | (_) \ V  V /| |___| (_| | | | | (_| |
 |_|  \_\__,_|_|_| |_|_.__/ \___/ \_/\_/ |______\__,_|_| |_|\__,_|

